Source
http://en.wiktionary.org/wiki/Special:AllPages/%E3%81%82

Words for e
   egaku - to draw
   eshaku - bow/nod
   ensan - HCl

words for i
   ikaru - to anger
   ishizue - foundation stone
   itsuke - instruction/command/orders
   ikebana - flower arrangement
   itamidome - painkiller
   itami - pain
   isu - chair
   imo - potato
   ibiki - snoring
   
words for ki
   kizuna - shackles (bond b/w ppl)
   kirai - hate
   kirakira - twinkle, glisten
   kijutsu - magic
   kinoko - mushroom
   ki - energy
   
words for ku
   kusai - bad smell
   kuda - pipe, tube
   kujaku - peacock
   kuki - air
   kugi - nail
   kuro - black
   kurukuru - spinning
   
words for ke
   keitai - mobile phone
   keisatsu - police
   kenjutsu - fencing
   ketsueki - blood
   
words for ko
   kokoro - heart
   kosoku - light speed
   kosuiryo - rainfall, precipitation
   koru - to freeze
   kogeru - to be burned
   komorigasa - umbrella
   kosokoso suru - sneak
   kongoseki - diamond
   kowai - scary/eerie
   
   